############################
# #      #                 #
# # ####   ############### #
# # #    # #               #
# # #### # # ###############
# # #    # # #             #
# # # #### ### ########### #
# # # #        #           #
#       ################## #
#########    # # #       # #
# #       #### # ####### # #
# # ### ###  # # #       # #
#   #       ##   # ##### # #
##### #######  # #     # # #
#     #       ## ## #### # #
# ##### #######     #      #
#       #       ############
####### #########        # #
#       #         ######## #
# ####### ###### ##   #     
#         #         #   ## #
############################